NO ./texture.xpm
SO ./path_to_the_south_texture.xpm
WE ./path_to_the_west_texture.xpm
EA ./path_to_the_east_texture.xpm

F 220,100,0
C 225,30,0



       111
1111111101
1000000001
1000000001
1000000001
1000100001
1000000001
1000N00001
1000111111
11111     
