NO ./texture.xpm
SO ./path_to_the_south_texture.xpm
WE ./path_to_the_west_texture.xpm
EA ./path_to_the_east_texture.xpm

F 220,100,0
C 225,30,0



       111       111
11111111011111111101
10000000000000000101
10000000000000000101
10000000000000000101
10000000000000000101
10000000000000000101
10000000000000000001
10000000000000000001
10000000000000000001
10000000010000000001
10000000000000000001
10000000000000000001
11111110000000000001
100000000E0000000001
10000000000000111111
100000000001001     
100000000001001     
100011111111111     
11111               
