NO  ./texture/N.xpm
SO ./texture/S.xpm
WE ./texture/W.xpm
EA ./texture/E.xpm

F  94,74,74
C 105,29,122



11111111
10010001
10020001
11210001
10000001
10N00101
10000001
11111111
